Il grasso è insano, fumare è insano	Fett&nbsp;ist ungesund, rauchen ist ungesund	german translation
Da dove vieni?	woher kommst du?	german translation
"Qual'è la differenza tra danke e Danke schön?"	Grazie / molte grazie (thank you very much)	german
Come cambia la preposizione&nbsp;<u>in</u>&nbsp;in base al caso da cui è seguita?	"<u>Posizione</u>&nbsp;se seguita dal <u>dativo</u><br>Du bist im (= in dem) Supermarkt<br>Ich jogge in dem Park (corro nel parco)<br><br><u>Direzione&nbsp;</u>se seguita <u>dall'accusativo</u><br>Sie geht in den Supermarkt<br>Ich jogge in den Park (corro al parco)"	german grammar
Vado in bagno	ich gehe zur Toilette<br><br>zu regge sempre il dativo	german translation
Lui arriva oggi	Er kömmt heute an	german translation
Accendi la luce&nbsp;	mach das Licht an	german translation
Spengo tutte le luci quando vado a letto&nbsp;	Ich mache alle Lichter aus, wenn ich ins Bett gehe	german translation
Per poter partecipare a questo programma, il candidato deve…	Um bei diesem Programm mitmachen zu können, muß der Neukunde …	german translation
Sai quando il supermercato aprirà?	Weißt du, wann der Supermarkt <strong><em>aufmacht</em></strong>? &nbsp;	german translation
Qual’è la differenza tra i verbi formati da un prefisso + machen (eg anmachen, ausmachen, mitmachen (accendere, spegnere, partecipare) e alternative?	Verbi con machen sono più usati in tono informale, day to day. Sono come i phraseal verbs inglesi.	german
Voglio che chiudi gli occhi&nbsp;	Ich möchte, dass du die Augen zumachst	german translation
Porta via il tuo mucchio di spazzatura dal mio prato inglese amorevolmente tosato.	Machen Sie sein Müllhaufen von meinem liebevoll gepflegten englischen Rasen weg.	german translation
Il comico imita il politico&nbsp;	der Komiker macht den Politiker nach	german translation
Ti piace bere il caffè?	trinken sie gerne kaffee?	german translation
Ti piace mangiare frutta e verdura?	Essen Sie gerne Obst und Gemüse?	german translation
Perchè non si dovrebbe provare tutti i funghi?&nbsp;	Warum soll man nicht alle Pilze probieren?	german translation
Perchè i bambini ricevono regali a Natale?	Warum bekommen Kinder Geschenke zu Weihnachten?	german translation
Perchè ci si dovrebbe lavare regolarmente?	Warum soll man regelmäßig baden/duschen?	german translation
É veramente bello che tu sia venuto a cercarmi!	Es ist wirklich schön, dass&nbsp;du mich besucht&nbsp;hast!	german translation
gli studenti sono affamati. <br>La fame degli studenti è grande. <br>Gli studenti ringraziano gli insegnati per il cibo.	<u>Die</u> Schüler sind hungrig (nominativ plural)<br>Der Hunger <u>der</u> Schüler ist groß (genitiv plural)<br>Die Schüler danken <u>den</u> Lehrern für das Essen (dativ plural)	german grammar translation
Mia nonna ha 85 anni	Meine Oma/Großmutter ist 85 (fünfundachtzig)	german translation
Mi lavo i capelli	Ich washe mir die Haare	german translation
Jacopo è troppo piccolo per laversi le mani da solo, io gli lavo le mani	Jacopo ist zu jung, um sich (pronome riflessivo) selbst die Hände zu waschen, ich wasche <u>ihm</u> (dativ) die Hände	german translation
Tu vai a casa?	Du gehst nach Hause?	german translation
Giolele aiuta a casa	Giolele hilft zu Hause	german translation
Domani gioco a calcio perchè mi devo allenare tanto	Ich spiele morgen fußball weil ich viel trainieren muss	german translation
Ti aiuto quando vuoi	Ich helfe dir, wann du willst	german translation
Ricordi ancora il giorno in cui ci siamo incontrati per la prima volta?	Erinnerst du dich noch an den Tag, wann wir uns zum ersten Mal begegnet sind?	german translation
Verbi separabili	Trennbare Verben	german translation
Lei pulì la sua stanza prima che arrivassero i suoi ospiti	Sie räumte ihr Zimmer auf, bevor ihre Gäste eintrafen	german translation
Chi pulisce la griglia?	Wer&nbsp;macht&nbsp;den Grill&nbsp;sauber?	german translation
Puoi caricare la lavastoviglie?&nbsp;<div>(Nel senso di mettere le stoviglie all’interno)</div>	Kannst du die Spülmaschine&nbsp;einräumen?	german translation
Mangi (tu) volentieri Brezeln?	Isst&nbsp;du gerne Brezeln?&nbsp;	german translation
A cosa corrisponde in italiano il tempo verbale Imperfekt?&nbsp;	Al passato remoto.<br>Imperfekt è sinonimo di Präteritum	german grammar
A che tempo verbale corrisponde il Präteritum?	Al passato remoto.<br>Imperfekt è sinonimo di Präteritum.<br><br>Il Perfekt è il passato prossimo.	german grammar
Quando si una Imperfekt o Präteritum?	<u>Non si usa nel parlato</u>, se non per i&nbsp;<u>verbi modali</u>, essere / avere e pochi altri.<br>É comune per tutti i verbi nello scritto, storie, articoli accademici.<br>Nel parlato si preferisce il Perfekt	german grammar
Anno scorso sono andato in vacanza in Germania	Im letzten Jahr machte ich Urlaub in Deutschland	german translation
Avevi un cane da bambino?	Hatten&nbsp;Sie als Kind einen Hund?	german translation
Sei corso via molto velocemente	Du&nbsp;liefst&nbsp;ganz schnell weg (weglaufen, laufen - lief - gelaufen)	german translation
Ieri ero al cinema e ho mangiato popcorn	Gestern war ich im Kino und habe Popcorn gegessen	german translation
Hai vissuto a Berlino?	Hast du in Berlin gewohnt?	german translation
Quanto costa noleggiare una bici?	Wie viel kostet es, ein Fahrrad zu mieten?	german translation
Cosa sono i Wäcke/Starke Verben?&nbsp;	Quelli deboli si coniuganoregolarmente, quelli forti sono irregolari	german grammar
M... non&nbsp;vorrei&nbsp;farlo di nuovo	<div><div>Aber&nbsp;ich würde&nbsp;das nicht wiederholen.<br></div></div><div><br></div><div>In questa frase Werden è usato non come passivo ma come&nbsp;<u>Konjunktiv&nbsp;II</u></div>	german grammar translation
Come si forma il perfekt dei verbi regolari, 3 casi	<ul><li>Prefisso GE e suffisso T:</li><ul><li>SAGEN – GESAGT</li><li>KAUFEN – GEKAUFT</li><li>LERNEN – GELERNT</li></ul><li>Se la radice del verbo termina in T o D aggiungiamo una E:</li><ul><li>ARBEITEN – GEARBEITET</li><li>WARTEN – GEWARTET</li><li>REDEN – GEREDET</li></ul><li>Se verbo finisce&nbsp; con -IEREN non usiamo il prefisso GE:</li><ul><li>TELEFONIEREN – TELEFONIERT</li><li>FUNKTIONIEREN – FUNKTIONIERT</li></ul></ul>	german grammar
Quando aiuti Paul? Lo ho già aiutato	Wann hilfst du Paul? Ich habe ihm shon geholfen	german translation
"Quando chiudi la finestra? L'ho già chiusa"	Wann shließt du das Fenster? Ich habe es shon geschlossen	german translation
Cosa sonoi gemischte verben?	"I verbi misti sono misti in quanto al Perfekt:<br><ul><li style=""text-align: center; "">hanno suffisso -t come i verbi regolari</li><li style=""text-align: center; "">ma la radice del verbo cambia</li></ul><div>Normalmente i verbi che cambiano radice sono irregolari e tutti hanno -en come prefisso dell'imperfekt</div><div>Sono pochi:</div><div><img src=""paste-ea1834c0e4ef5c453c931f656f460b4dd44b6d39.jpg"" width=""340""><br></div>"	german grammar
Dopo averci pensato a fondo, metto il piano in pratica	Nachdem ich lange nachgedacht habe, setze ich den Plan in die Tat um	german translation
mettere in pratica	in&nbsp;die&nbsp;Tat&nbsp;umsetzen	german translation
<div>pensare&nbsp;a&nbsp;una&nbsp;soluzione&nbsp;migliore<br></div>	eine&nbsp;bessere&nbsp;Lösung&nbsp;überlegen<br>über eine bessere Lösung nachdenken	german translation
"escalation di verbi per dire ""pensare"", ognuno indica un pensare sempre più intenso"	denken<br>nachdenken<br>ubërlegen	german
L’arrivo (formale, NON ANKUNFT) della delegazione &nbsp;<div><br></div>	Das Eintreffen der Delegation &nbsp;	german translation
I nostri ospiti d’onore sono arrivati	unsere Ehrengäste sind eingetroffen	german translation
Aprite, in nome del governatore&nbsp;	<div><div>Aufmachen, im Namen des Stadtrichters</div></div>	german translation
Hai (tu) un carica cellulare?	Hast du ein Handy-Ladegerät?	german translation
Mi sono dovuto sbottonare un paio di bottoni	Ich musste ein paar Knöpfe&nbsp;aufmachen	german translation
Con poche eccezioni, però, tutto è rimasto uguale	Bis auf einige Ausnahmen ist aber alles beim alten&nbsp;geblieben	german translation
Molti sviluppano malattie del fegato inosservate	Viele erkranken unerkannt an der Leber	german translation
Uomini e donne contraggono il Covid-19 in modo diverso?	Erkranken Männer und Frauen unterschiedlich an Covid-19?	german translation
Io non ho paura, Gesù è con me	Ich fürchte mich nicht - Jesus! ist bei mir!	german translation
Sono diventato grande, ma non ho smesso di avere paura del buio	Ich bin erwachsener geworden, aber ich habe nicht aufgehört, mich vor der Dunkelheit zu fürchten.	german translation
"Sto cercando di godermi la Marvel, ma l'umorismo fa schifo"	Ich versuche Marvel zu genießen, aber der Humor Ist unterirdisch (sehr schlecht)	german translation
Differenza tra&nbsp;möchten e wollen	möchten: would like to (polite)<br>wollen: want&nbsp;	german grammar
Noi vogliamo la pizza!	Wir&nbsp;wollen&nbsp;die Pizza!<br>♀ die Pizza	german translation
Mi piace il cibo asiatico, soprattutto tailandese	Ich mag asiatisches Essen, insbesondere thailändisch	german translation
Vi piace il vino? (con Mögen)	Mögt ihr Wein?	german translation
Poi mi ha detto:&nbsp;dovresti firmare col tuo sangue.	Er hat mir dann gesagt:&nbsp;du sollst&nbsp;mit deinem Blut unterschreiben.	german translation
"L'albero vuole vedere il sole"	Der Baum will die Sonne sehen	german translation
io devo andare in bagno! (informale)	ich muss mal auf die toilette gehen	german translation
Porta sempre con te un maglione o una giacca in autunno	Im Herbst immer einen Pulli oder eine Jacke mitnehmen	german translation
Io ti piaccio più di quanto tu credi	Du magst mich&nbsp;viel mehr, als du glaubst.	german translation
Lavori in corso	"<img alt=""In Arbeit – Tinker Bella's Shop"" src=""ed106c3bf892c6cd9112180eebc6ebebcecba193.gif"">"	german translation
"La strada era vuota, tranne per l'occasionale passante"	Die Straße war leer bis auf gelegentliche Fußgänger.	german translation
il sangue scorre nelle vene	das Blut fließt durch die Adern	german translation
The weather tomorrow will be sunny with occasional rain	Das Wetter morgen wird sonnig sein mit gelegentlichem Regen	german translation
Io mi rendo ridicolo, tu ti rendi ridicolo, lui si rende ridicolo	Ich mache mich zum Affen,<br>Du machst dich zum Affen,<br>Er macht sich zum Affen	german translation
Perchè lei riceve sempre un trattamento speciale? (idimatico)	Warum bekommt sie immer eine Extrawurst?	german translation
Posso chiedere un trattamento speciale?	Könne Ich eine Extrawurst verlangen?<br>♀die Wurst&nbsp;	german translation
Vai questa sera alla festa di Lydia? É veramente una bomba&nbsp;	Gehst du heute Abend zu Lydias Party? Da steppt wirklich der Bär!	german translation
"Dove c'è la festa a Vienna oggi? (idiomatico)"	Wo steppt der Bär in Wien heute?	german translation
É greco per me / Non sto capendo una mazza (idiomatico)	Ich verstehe nur Bahnhof	german translation
Chiaro come il cristallo / ovvio (idiomatico)	klar wie kloßbrühe	german translation
pretendere una spiegazione	eine&nbsp;Erklärung&nbsp;verlangen	german translation
"C'è molto da fare"	Es gibt viel&nbsp;zu&nbsp;tun	german translation
"Lui va all'areoporto"	er fährt&nbsp;zum&nbsp;Flughafen<br><br>fahren&nbsp;+&nbsp;zu&nbsp;+&nbsp;dative&nbsp;(to drive to a person or place with a name)	german translation
"Io riordino/sistemo la soffitta, c'è molta polvere"	Ich räume den Dachboden auf, es gibt viel Staub	german translation
"I miei 5 errori più grandi dell'anno scorso!"	Meine 5 größten Fehler im letzten Jahr!&nbsp;	german translation
<div>Alle famiglie di Aleppo, non è&nbsp;rimasto&nbsp;nulla<br></div>	Den Familien von Aleppo ist nichts&nbsp;geblieben	german translation
Non essere ridicolo (idiom), è soloun raffeddore	Lass die Kirche im Dorf. Es ist nur eine Erkältung.	german translation
Cambio costantemente i vestiti, mi incollo le unghie, le dipingo o penso a un altro coglione (idiom)	Ich zieh mich ständig um, klebe meine Fingernägel wieder an, lackiere sie, oder ich denke an einen anderen Arsch mit Ohren.<br><br>(denken + an regge akk.)	german translation
Mi piaci in qualche modo, tu completo idiota (idiom)	Du gefällst mir irgendwie, du Arsch mit Ohren.	german translation
<div>Jocker è piuttosto&nbsp;imprevedibile e incline ad uccidere<br></div>	Jocker ist&nbsp;irgendwie&nbsp;unberechenbar und mordlustig.	german translation
"<div><div>Senta,&nbsp;imbecille, non c'è nulla della mia malattia che lei mi possa dire, che io non sappia.</div></div>"	Hören Sie zu, Sie&nbsp;Arschgeige, Sie können mir nichts über meine Krankheit sagen, was ich nicht längst weiß.	german translation
Faccio solo una doccia e mi cambio	Lass mich duschen und mich&nbsp;umziehen.	german translation
Perchè è il meteo così imprevedibile?	Warum ist das Wetter so unberechenbar?	german translation
Quando vado al bar io divento imprevedibile	wann ich gehe zur Bar, ich bekomme unberechenbar	german translation
Leccami il culo!	Leck mich im Arsch	german translation
Mi dispaice, sono pazzo	Tut mir Leid,&nbsp;ich spinne	german translation
"Di cosa ti interessi?<br>Mi interessa l'informatica"	Für&nbsp;was interessierst Du Dich?<br>Ich interessiere mich für Informatik	german translation
"Che cos'è una settimana di progetto (~ autogestione) ? È una settimana in cui gli studenti si dedicano a un progetto interdisciplinare."	Was ist eine&nbsp;Projektwoche? Es handelt sich um eine Woche, in der sich die Schüler:innen fächerübergreifend einem Projekt widmen.<br><br>(Schüler:innen): gneder neutral, plural	german translation
Una striscia si muove sullo schermo	Ein Streifen wandert über den Bildschirm	german translation
fare escursione in montagna è faticoso	Wandern in den Bergen ist anstrengend<br><br>in + dativ	german translation
Ha conosciuto sua moglie un venerdì	Er hat seine Frau an einem Freitag kennengelernt	german translation
Mi ha accompagnato a casa	Sie hat mich nach hause gefahren	german translation
un ristorante costoso	ein teures Restaurant<br><br>☯ Restaurant	german translation
Le priorità vengono definite ad un livello alquanto concettuale&nbsp;e multidisciplinare.	Die Prioritäten sind ziemlich theoretisch und&nbsp;fächerübergreifend&nbsp;angelegt.	german translation
regolare qualcosa in tutta Europa / a livello europeo	etwas übergreifend für Europa regeln<br><br>übergreifend means overarching	german translation
Quali materie non ti piacciono?	Welche Fächer hast du nicht gern?	german translation
Godetevi la calma e&nbsp;dedicarsi&nbsp;ai tuoi interessi.	Genießen Sie die Ruhe und&nbsp;widmen&nbsp;Sie sich Ihren Interessen.	german translation
<div><div><div><div>Le radici della pianta sono&nbsp;sotterranee</div></div></div></div>	Die Wurzeln der Pflanze sind unterirdisch	german translation
restare in incognito	unerkannt bleiben	german translation
<div>I veterinari&nbsp;dedicano&nbsp;la propria vita agli animali<br></div>	Tierärzte&nbsp;widmen&nbsp;ihr Leben den Tieren<br><br>☯ Das Leben	german translation
i vizi hanno costantemente bisogno di soldi	die Laster brauchen ständig Geld	german translation
"L'arrivo dell'inverno"	Die Ankunft des Winters<br><br>♀ Die Ankunft	german translation
Mi sono nascosto quando arrivarono i poliziotti	Ich habe mich versteckt, als die Cops&nbsp;eintrafen	german translation
<div>Jo mi ha&nbsp;accompagnato&nbsp;oltre il confine<br></div>	Jo hat mich über die Grenze&nbsp;gefahren	german translation
Puoi staccare un materiale da questa carta:	Du kannst 1 Material von dieser Karte abhängen:<br><br>♀ Die Karte	german translation
Bandisci le top 10 carte dalla cima del tuo Deck, coperte;	Verbanne die obersten 10 Karten verdeckt von deinem Deck<br><br>verbanne: imperativo presente seconda persona singolare	german translation
se questa carta ha distrutto un mostro in battaglia:	falls diese Karte ein Monster durch Kampf zerstört hat:<br><br>☯ das Monster	german translation
Se una carta che il tuo avversario possiede e comanda è bandita coperta,	Falls eine Karte, die deinem Gegner gehört und die er besitzt, verdeckt verbannt wird,&nbsp;	german translation
eccetto durante il Damage Step	außer während des Damage Steps<br><br>während + genitiv (la maggior parte delle volte)	german translation
La preposizione an regge dativo o accusativo?	"Entrambi, essa è una Wechselpräpositionen, a seconda dell'uso cambia caso"	german grammar
Il caso solleva alcuni misteri	Der Fall wirft einige Rätsel auf<br><br>☯ das Rätsel	german translation
"L'incendio nell'azienda chimica"	Der Brand im Chemiekonzern	german translation
Sto uscendo di casa	ich gehe aus dem Haus	german translation
"Un'ora al massimo e&nbsp;sarò a casa."	Maximal eine Stunde und&nbsp;ich bin zu Hause.	german translation
Sono a casa (senza usare casa)	ich bin daheim	german translation
La casa a schiera	Das&nbsp;Reihenhaus	german translation
La casa singola (detached house)	Das Einfamilienhaus	german translation
Villetta bifamiliare	Das&nbsp;Doppelhaus	german translation
Il rustico fa parte di una piccola fattoria	Das&nbsp;Bauernhaus&nbsp;ist Teil einer kleinen Farm<br><br>♀ die Farm	german translation
Ferie in agriturismo	Urlaub auf dem Bauernhof	german translation
"Il mio appartamento è all'ultimo piano dell'edificio"	Meine Wohnung ist im obersten Stockwerk/Stock des Gebäudes.	german translation
Quando&nbsp;<i>einige&nbsp;</i>viene seguito dal plurale o singolare?	"<div><ul><li>plurale se significa molti:&nbsp;<i>einige Änderungen,&nbsp;einige Beispiele</i>&nbsp;(alcune modifiche, alcuni esempi).</li><li>Singolare se significa qualche:&nbsp;<i>einige Zeit,&nbsp;einige Hoffnung</i> (un po' di tempo, un po' di speranza).</li><li>An exception is&nbsp;<i>einige Mal</i>&nbsp;as a colloquial form of&nbsp;<i>einige Male</i></li></ul></div>"	german grammar
Che caso segue la preposizione zu?	"Sempre il dativo, anche quando è moto a luogo e la regola vorrebbe l'accusativo"	german grammar
Il matrimonio&nbsp;	die Hochzeit	german translation
Fuori dai piedi&nbsp;	Aus dem Weg	german translation
la chiave non funziona, la porta rimane aperta	Der Schlüssel funktioniert nicht, die Tür bleibt offen	german translation
un Episodio	ein Folge	german translation
"Daniel ha un po' di mal di gola"	Daniel hat ein bischen Halsschmerzen	german translation
Daniel pensa che Zerocalcare sia molto divertente e anche molto emotivo	Daniel denkst dass Zerocalcare ist sehr witzig und auch ganz emotionale	german translation
Lángos è un piatto popolare a Budapest	Lángos ist eine beliebte Speise in Budapest	german translation
Daniel consiglia il film	Daniel empfehlst den Film&nbsp;	german translation
"I medici consigliano l'attività fisica"	Ärzte empfehlen körperliche Aktivität	german translation
alzare la casa di un piano	das Haus um ein Stockwerk erhöhen	german translation
Il bagno è tra la cucina e il soggiorno	Das Bad liegt zwischen der Küche und dem Wohnzimmer<br><br>♀ die Küche<br>☯ Das Bad	german translation
A cosa serve gerade?	Gerade serve per formare la forma progressiva, corrispondente al gerundio.<br><br>Kannst du später nochmal anrufen? Ich&nbsp;koche&nbsp;gerade.<br>Puoi chiamare più tardi? Sto cucinando.	german grammar
Solo il bagno era stato completamente rifatto, con vasca in marmo	Nur das Badezimmer war vollständig neu gemacht worden, mit einer Wanne aus Marmor	german translation
I miei amici preferiscono un soggiorno confortevole in hotel al campeggio romantico.	Meine Freunde ziehen eine bequeme Hotelübernachtung romantischem Zelten vor.<br><br>♀ die&nbsp;Übernachtung<br>☯ das Zelten: campeggio&nbsp;<br>☯ das Zelte: tenda&nbsp;	german translation
Trovo la mia camera confortevole	Ich finde mein Zimmer bequem<br><br>☯ das Zimmer	german translation
Jens, facciamo sesso (espressione gergale)	Jens, lass&nbsp;uns&nbsp;vögeln	german translation
Il cassetto è di legno	Die Schublade ist aus Holz<br><br>♀ die Schublade	german translation
<div>Gli Youtuber di successo sono interattivi,&nbsp;divertenti&nbsp;e onesti<br></div>	Erfolgreiche Youtuber sind interaktiv,&nbsp;witzig&nbsp;und ehrlich	german translation
Alzare i prezzi	die Preise erhöhen	german translation
Inoltre, dopo la guerra, le famiglie ebree avevano altre preoccupazioni oltre a chiedere giustizia.	 Dazu kommt, daß die jüdischen Familien nach dem Krieg andere Sorgen hatten, als Gerechtigkeit zu verlangen.&nbsp;	german translation
Il tappeto è sotto la sedia	Der Teppich liegt unter dem Stuhl	german translation
La lampada è sopra la scrivania	Die Lampe ist über dem Schreibtisch	german translation
Abbiamo molti bidoni della spazzatura nel mondo, ma una sola natura	Wir haben viele Abfalleimer auf der Welt, aber nur eine Natur<br><br>♀ die Natur<br>♀ die Welt	german translation
La mia camera da letto è sul lato della strada della casa	Mein Schlafzimmer liegt an der Straßenseite des Hauses<br><br>♀ die Seite<br>an + dativ = posizione	german translation
"Abbiamo fatto realizzare l'armadio dal falegname."	Den Schrank haben wir uns vom Tischler machen lassen	german translation
Coniugazione treffen (terza persona presente, Präeterium, Perfekt)	sie trifft<br>traf<br>getroffen	german grammar
Io preferisco le vacanze al mare	Ich ziehe&nbsp;Urlaub&nbsp;am&nbsp;Meer vor	german translation
"Se ti prendi davvero cura di questa macchina, durerà un altro paio d'anni."	Wenn du das&nbsp;Auto&nbsp;gut pflegst, hält es noch ein&nbsp;paar&nbsp;Jahre.	german translation
Tutti i lati di un dado sono grandi uguali	Alle Seiten eines Würfels sind gleich groß.	german translation
sedere <u>al</u> bar	<u>an</u> der&nbsp;Bar&nbsp;sitzen<br><br>♀ die Bar<br>an + dativ = posizione	german translation
Il cestino è pieno di plastica	Der Abfalleimer ist voll mit Plastik	german translation
"Potremmo magari dare priorità a questo punto all'ordine del giorno?"	Könnten wir diesen Tagesordnungspunkt vielleicht vorziehen?	german translation
Si è lamentato con il capo con successo	Er hat sich erfolgreich beim&nbsp;Chef&nbsp;beschwert	german translation
Il tempo ci sfugge	"Die Zeit&nbsp;läuft&nbsp;uns&nbsp;weg<br><br><span style=""color: rgb(51, 51, 51);"">♀ die Zeit</span>"	german translation
Vorrei lamentarmi della qualità degli amplificatori	"Ich möchte mich über die Qualität der Verstärker beschweren<br><br><span style=""color: rgb(51, 51, 51);"">♀ die&nbsp;</span>Qualität"	german translation
Sacher con panna montata	Sachertorte mit Schlag&nbsp;	german translation
"in caso di maltempo l'evento non si svolgerà all'esterno, ma all'interno"	bei schlechtem Wetter wird die Veranstaltung nicht draußen, sondern drinnen stattfinden	german translation
"Gli eventi hanno obiettivi diversi , da cui derivano il ""design dell'evento"" e la forma dell'evento"	"Veranstaltungen haben unterschiedliche Ziele, aus denen sich das „Veranstaltungsdesign“ und die Veranstaltungsform ableitet<br><br><span style=""color: rgb(51, 51, 51);"">♀ die Form<br></span>☯ das Design"	
"L'ho trovato (il film) piuttosto lungo, per non dire noioso"	Ich habe ihn ziemlich lang gefunden, um nicht zu sagen langweilig	german translation
"<img src=""Frame 1.png"">"	&nbsp;☯ das Waschbecken	german
"<img src=""image 2.png"">"	der&nbsp;Staubsauger	german
Quando è arrivato a casa sua moglie stava cucinando	Seine Frau war beim Kochen, als er zu Hause angekommen ist<br><br>beim + verbo sostantivato = gerundio	german translation
Il pollo è cotto	Das Hähnchen ist&nbsp;gekocht	german translation
Ho corso	Ich bin gelaufen	german translation
Ho avuto un sogno terribile	Ich hatte einen&nbsp;schrecklichen&nbsp;Traum	german translation
Mi ha dato la sensazione come se qualcosa lì fosse terribilmente fuori controllo.	Es gab mir das Gefühl, daß da etwas schrecklich außer Kontrolle ist.<br><br>☯ das Gefühl: la sensazione	german translation
"Io odio l'aceto sulle patate (fritte)"	Ich hasse Essig auf Pommes	german translation
Sto uscendo	Ich komme raus	german translation
Maria porta la spazzatura fuori	Maria bringt den Müll raus	german translation
il cortile	der Hof	german translation
Nome del sistema di vuoto a rendere delle bottiglie a Berlino	Das Flaschenpfand	german translation
"Il deterioramento dell'ambiente&nbsp;sta certamente continuando a ritmo elevato."	Die Verschlechterung der&nbsp;Umwelt&nbsp;steigt rapide an.<br><br>♀ die Umwelt	german translation
"foglie cadute per terra<br><img alt=""Laub – Wiktionary"" src=""1200px-Fallen_autumn_leaves_with_Orton_effect.jpg"" width=""364"">"	das Laub	german translation
Mi lavo i denti	Ich putze meine Zähne&nbsp;<br>OR Ich putze mir die Zähne	german translation
Lea è stata ospsitale con me	Lea war gastfreundlich zu mir	german translation
"Mittags vs am Mittage, ricordando l'esempio ""A pranzo vado sempre al bar all'angolo"""	"Mittags per azioni che si ripetono con regolarità:<br><ul><li>Mittags gehe ich immer in das Café an der Ecke (all'angolo)</li></ul>Am Mittag per un azione che non si ripete:<br><ul><li>Am Mittag gehe ich in das Café an der Ecke (ci vai solo oggi)</li></ul>"	german usage_note_german
la mattina	der Vormittag	german translation
"l'altro ieri"	vorgestern	german translation
dopodomani	übermorgen	german translation
mai	niemals	german translation
quasi mai	fast nie	german usage_note_german
hier vs da vs dort	hier: qui<br>da: lì&nbsp;<br>dort: lì ma ad una distanza superiore<br><br>in pratica da e dort sono intercambiabili	german usage_note_german